1111111111111111111111111111111111111111111111111111111111111111111
1111111111111111111111111111111111111111111111100111111111111111111
1111111111111101111101111101111111111111111111100111111111111111111
1111111101111101111101111101111111111111111111100111111111111111111
1111111101111101111101111101111111111111111111100111111111111111111
1111111101111101111101111101111111111111111111100111111111111111111
1111111101111101111101111101111111111111111111100111111111111111111
1111111101111101111101111100000000000011111111100111111111111111111
1111111101111101111101111100000000000011111111100111111111111111111
1111111101111101111101111100000000000011111111100111111111111111111
1111111101111101111101111100000000000011111111100111111111111111111
1111111101111101111101111100000000000011111111100111111111111111111
1111111101111101111101111100000000000011111111100111111111111111111
1111000000000000000000000000000000000000000000000000000000000001111
1111111101111101111101111100000000000011111111100111111111111111111
1111111101111101111101111100000000000011111111100111111111111111111
1111111101111101111101111100000000000011111111100111111111111111111
1111111101111101111101111100000000000011111111100111111111111111111
1111111101111101111101111100000000000011111111100111111111111111111
1111111101111101111101111100000000000011111111100111111111111111111
1111111101111101111101111100000000000011111111100111111111111111111
1111111101111101111101111100000000000011111111100111111111111111111
1111111101111111111111111100000000000011111111100111111111111111111
1111111101111111111111111100000000000011111111100111111111111111111
1111111101111111111111111100000000000011111111100111111111111111111
1111111100000000000000000000000000000011111111100111111111111111111
1111111101111111111111111101111111111111111111100111111111111111111
1111111101111111111111111101111111111111111111100111111111111111111
1111111101111111111111111101111111111111111111100111111111111111111
1111111101111111111111111101111111111111111111100111111111111111111
1111111121111111111111111101111111111111111111100111111111111111111
1111111111111111111111111101111111111111111111100111111111111111111
1111111111111111111111111111111111111111111111100111111111111111111
1111111111111111111111111111111111111111111111100111111111111111111
1111111111111111111111111111111111111111111111111111111111111111111