111111111111111111111111111111111111111111
100000000000100000000000000000000000000001
100000000000100000000000000000000000000001
100000000000100000000000000000000000000001
100001111111100000000000000000000000000001
100001000000000000000011111111111000000001
100001000000000000000010000000001000000001
100001000000000000000010000000001000000001
100001000000000000000010000000001000000001
100001000000000000000010000000001000000001
100001000000000000000010000000001000000001
100001111111111111111110000000001000000001
100000000000000000000000000000001000000001
100000000000000000000000000000000000000001
100000000000000000000000000000000000000001
100000000000000000000000000001001000000001
100000000000000000000000000001001000000001
100000000000000000000000000001001000000001
100000000000000000000000000001111000000001
100000000000000000000000000000000000000001
100000000000000000000000000000000000000001
100000000000000000000000000000000000000001
100000000000000000000000000000000000000001
100000000000000000000000000000000000000001
100000000000000000000000000000000000000001
100000000000100000000001000000000000000001
100000000000100000000001000000000000000001
111111111111111111111101111111111111111111
111111111111110000000001111111100000000111
111111111111111000001111111111100000000111
111111111111111100011111111111100000000111
111111111111111000111111111111100000000111
111111000000000001111111111111100000000111
111111001111111111111111111111100111100111
111111000000000000000000000000001111100111
111111111111111111111111111111111111100111
100000000000000000000000000000000000000001
100010000000000000000000000000000000000001
100010000000000000000000000000000000010001
100010000000000000000000000000000000010001
100010000000000000000000000000000000010001
100000000000000000000000000000000000010001
100010000000000000000000000000000000010001
100010000000000000000000000000000000010001
100000000000000000000000000000000000000001
111111111111111111111111111111111111111111