111111111111111111111111111111111111111111
100000000000000000000000000000000000001011
100000000001111111011111101111110101111111
100000000000101111111111100000001001111111
100000000000000000000000000000000000100111
100000000000000000000000000000000001100111
100000000000000000000000000000000000000001
100000000000000000000000000000000000000001
100000000000000000000000000000000000000001
100000000000000000000000000000000000000001
100000000000000000000000000000000000000001
100000000000000000000000000000000000000001
100000000000000000000000000000000000000001
100000000000000000000000000000000000000001
100000000000000000000000000000000000001011
100000000001111111011111101111110101111111
100000000000101111111111100000001001111111
100000000000000000000000000000000000100111
100000000000000000000000000000000001100111
100000000000000000000000000000000000000001
100000000000000000000000000000000000000001
100000000000000000000000000000000000000001
100000000000000000000000000000000000000001
100000000000000000000000000000000000000001
100000000000000000000000000000000000000001
100000000000000000000000000000000000000001
100000000000000000000000000000000000000001
111111111111111111111111111111111111111111
