1111111111111111111111111111111111111111111111111111111111111111111
1111111111111111111111111111111111111111111111100111111111111111111
1111111111111001111001111100111111111111111111100111111111111111111
1111111001111001111001111100111111111111111111100111111111111111111
1111111001111001111001111100111111111111111111100111111111111111111
1111111001111001111001111100111111111111111111100111111111111111111
1111111001111001111001111100111111111111111111100111111111111111111
1111111001111001111001111100000000000011111111100111111111111111111
1111111001111001111001111100000000000011111111100111111111111111111
1111111001111001111001111100000000000011111111100111111111111111111
1111111001111001111001111100000000000011111111100111111111111111111
1111111001111001111001111100000000000011111111100111111111111111111
1111111001111001111001111100000000000011111111100111111111111111111
1111000000000000000000000000000000000000000000000000000000000001111
1111000000000000000000000000000000000000000000000000000000000001111
1111111001111001111001111100000000000011111111100111111111111111111
1111111001111001111001111100000000000011111111100111111111111111111
1111111001111001111001111100000000000011111111100111111111111111111
1111111001111001111001111100000000000011111111100111111111111111111
1111111001111001111001111100000000000011111111100111111111111111111
1111111001111001111001111100000000000011111111100111111111111111111
1111111001111001111001111100000000000011111111100111111111111111111
1111111001111111111111111100000000000011111111100111111111111111111
1111111001111111111111111100000000000011111111100111111111111111111
1111111001111111111111111100000000000011111111100111111111111111111
1111111000000000000000000000000000000011111111100111111111111111111
1111111001111111111111111001111111111111111111100111111111111111111
1111111001111111111111111001111111111111111111100111111111111111111
1111111001111111111111111001111111111111111111100111111111111111111
1111111221111111111111111001111111111111111111100111111111111111111
1111111111111111111111111001111111111111111111100111111111111111111
1111111111111111111111111001111111111111111111100111111111111111111
1111111111111111111111111111111111111111111111100111111111111111111
1111111111111111111111111111111111111111111111100111111111111111111
1111111111111111111111111111111111111111111111111111111111111111111