111111111111111111111111111111111111111111111
100000000001111111110000000111111111111111111
111111100000001110000000011111111111111111111
111111111100000000000000111111111111111111111
111111100000001100000001111111111111111111111
100000001111111111000000111111111111111111111
100000000000000000000000000000001111111111111
100000000000011111000000111111111111111111111
100000000000000000000000000000000000111111111
100000000000000000000000000000000000111111111
100000000000000000000000000000000000000000111
100000000000000000000000000000000000000000011
100000000000000000000000000000001111111111111
100000000000011111000000111111111111111111111
100000000000000000000000000000000000111111111
100000000000000000000000000000000000111111111
100000000000000000000000000000000000000000111
100000000000000000000000000000000000000000011
100000000000000000000000000000001111111111111
100000000000011111000000111111111111111111111
100000000000000000000000000000000000111111111
100000000000000000000000000000000000111111111
100000000000000000000000000000000000000000111
100000000000000000000000000000000000000000011
100000000000000000000000000000001111111111111
100000000000011111000000111111111111111111111
100000000000000000000000000000000000111111111
100000000000000000000000000000000000111111111
100000000000000000000000000000000000000000111
100000000000000000000000000000000000000000011
100000000000000000000000000000001111111111111
100000000000011111000000111111111111111111111
100000000000000000000000000000000000111111111
100000000000000000000000000000000000111111111
100000000000000000000000000000000000000000111
100000000000000000000000000000000000000000011
100000000000000000000000000000001111111111111
100000000000011111000000111111111111111111111
100000000000000000000000000000000000111111111
100000000000000000000000000000000000111111111
100000000000000000000000000000000000000000111
100000000000000000000000000000000000000000011
100000000111111122211101111111111101111111111
111111111111111111111111111111111111111111111