11111111111111111111111111111111111111111111111111111111111111111111111111111111111111111
10000000000000000000000000000000000000000000000000000000000000000000000000000000000000001
10000000000000000000000000000000000000000010000000000000000000000000000000000000000000001
10000000000000000000000000001000000000000000000000000000000000000000000000000000000000001
10000000000000000000000000000000000000000010000000000000000000000000000000000000000000001
10000000000000000000000000001000000000000000000000000000000000000000000000000000000000001
10000000000000000000000000000000000000000010000000000000000000000000000000000000000000001
10000000000000000000000000000000000000000000000000000000000000000000000000000000000000001
10000000000000000000000000001000000000000010000000000000000000000000000000000000000000001
10000000000000000000000000000000000000000000000000000000000000000000000000000000000000001
10000000000000000000000000000000000000000010000000000000000000000000000000000000000000001
10000000000000000000000000001000000000000000000000000000000000000000000000000000000000001
10000000000000000000000000000000000000000010000000000000000000000000000000000000000000001
10000000000000000000000000001000000000000000000000000000000000000000000000000000000000001
10000000000000000000000000000000000000000010000000000000000000000000000000000000000000001
10001010101010101010101010101010101010101101010111101001010101010101010101010101000000001
10000000000000000000000000000000000000000000000000000000000000000000000000000000000000001
10001010101010101010101010101010101010101101010111101001010101010101010101010101000000111
10000000000000000000000000000000000000000000000000000000000000000000000000000000000000001
10000000000000000000000000000000000000000000000000000000000000000000000000000000000000001
10000000000000000000000000000000000000000000000000000000000000000000000000000000000000001
10000000000000000000000000000000000000000000000000000000000000000000000000000000000000001
10000000000000000000000000000000000000000000000000000000000000000000000000000000000000001
10000000000000000000000000000000000000000000000000000000000000000000000000000000000000001
10000000000000000000000000000000000000000000000000000000000000000000000000000000000000001
10000000000000000000000000000000000000000000000000000000000000000000000000000000000000001
10000000000000000000000000000000000000000000000000000000000000000000000000000011100000001
10000000000000000000000000000000000000000000000000000000000000000000000000000122210000001
10000000000000000000000000000000000000000000000000000000000000000000000000000010000000001
11111111111111111111111111111111111111111111111111111111111111111111111111111111111111111